1 13 31
###############################
#p      s* *    * 7 *  * * *  #
# #*# #*# # #*#b# # # #*#*#*# #
#   *     ***  *      *   * * #
# # # # # #*# # #*#*#*# # # #*#	
#f 3        **  *4  *         #
# # # # # # #   # #*# #*# # # #
#*  *                *        #
#####*# #*# # #  *#*# # # # # #
#*    **  *       *  *        #
###*# # # #*#    *# # # # # # #
#     6     *   * 5  *       x#
###############################
