1 13 31
###############################
#p      s* *    * 2 *  * * *  #
# #*# #*# # #*#b# # # #*#*#*# #
#   *     ***  *      *   * * #
# # # # # #*# # #*#*#*# # # #*#	
#f 3        **  2   *         #
# # # # # # #   # #*# #*# # # #
#*  *                *        #
#####*# #*# # #  *#*# # # # # #
#*    **  *       *  *        #
###*# # # #*#    *# # # # # # #
#     3     *   * 3  *       x#
###############################
